#####################
#.......#...........#
#.#.###.#.#####.###.#
#.#.....G.....#...#.#
#.###.#####.###.#.#.#
#.....#...#.....#...
###.###.#.###.#.###.#
#####################

