#############################
#.............#............#
#.#####.#####.#.#####.#####.#
#.#   #.#   #.#.#   #.#   #.#
#.# # #.# # #.#.# # #.# # #.#
#.# #...# #...#.# #...# # #.#
#.# ##### #####.# ##### # #.#
#.#.............#.....G.# #.#
#.#########.#########.### #.#
#...........P.............#.#
#############################

