#####################
#.......#...........#
#.#.###.#.#####.###.#
#.#.....G.....#...#.#
#.###.#####.###.#.#.#
#.....#...#.....#...#
#.###.#.#.#.###.#.#.#
#...#...P...#...#...#
###.###.#.###.#.###.#
#####################

